//MAP CONVERTED BY dmm2tgm.py THIS HEADER COMMENT PREVENTS RECONVERSION, DO NOT REMOVE 
"a" = (
/turf/template_noop,
/area/template_noop)
"b" = (
/turf/open/floor/plating/asteroid/snow/temperatre{
	initial_gas_mix = "o2=22;n2=82;TEMP=293.15"
	},
/area/template_noop)
"c" = (
/turf/closed/wall/shuttle/survival/nodiagonal,
/area/template_noop)
"d" = (
/obj/structure/flora/tree/pine,
/turf/open/floor/plating/asteroid/snow/temperatre{
	initial_gas_mix = "o2=22;n2=82;TEMP=293.15"
	},
/area/template_noop)
"e" = (
/turf/open/floor/pod,
/area/template_noop)
"f" = (
/obj/structure/table/reinforced,
/obj/item/weapon/paper_bin,
/turf/open/floor/pod,
/area/template_noop)
"g" = (
/obj/structure/chair/office/dark,
/turf/open/floor/pod,
/area/template_noop)
"h" = (
/obj/structure/chair/office/dark{
	dir = 4
	},
/turf/open/floor/pod,
/area/template_noop)
"i" = (
/obj/structure/table/reinforced,
/obj/item/weapon/folder,
/turf/open/floor/pod,
/area/template_noop)
"j" = (
/obj/structure/frame/computer{
	anchored = 1
	},
/turf/open/floor/pod,
/area/template_noop)
"k" = (
/obj/structure/table/reinforced,
/turf/open/floor/pod,
/area/template_noop)
"l" = (
/obj/structure/table/reinforced,
/obj/effect/landmark/vr_spawn{
	name = "Disk"
	},
/turf/open/floor/pod,
/area/template_noop)
"m" = (
/obj/structure/table/reinforced,
/obj/item/weapon/storage/box/donkpockets,
/turf/open/floor/pod,
/area/template_noop)
"n" = (
/obj/structure/table/reinforced,
/obj/item/weapon/pen,
/turf/open/floor/pod,
/area/template_noop)
"o" = (
/obj/structure/virtual/solidagent/atv,
/turf/open/floor/plating/asteroid/snow/temperatre{
	initial_gas_mix = "o2=22;n2=82;TEMP=293.15"
	},
/area/template_noop)
"p" = (
/obj/structure/chair/office/dark{
	dir = 1
	},
/turf/open/floor/pod,
/area/template_noop)
"q" = (
/obj/structure/closet/cardboard{
	always_eggs = 1;
	health = 100000
	},
/obj/item/weapon/storage/box/donkpockets,
/turf/open/floor/pod,
/area/template_noop)
"r" = (
/obj/structure/rack,
/turf/open/floor/pod,
/area/template_noop)
"s" = (
/obj/structure/punching_bag,
/turf/open/floor/pod,
/area/template_noop)
"t" = (
/obj/structure/chair/comfy/brown{
	dir = 1
	},
/turf/open/floor/pod,
/area/template_noop)
"u" = (
/obj/structure/chair/office/dark{
	dir = 8
	},
/turf/open/floor/pod,
/area/template_noop)
"v" = (
/obj/effect/landmark/vr_spawn{
	name = "Guard"
	},
/turf/open/floor/pod,
/area/template_noop)
"w" = (
/obj/structure/closet,
/turf/open/floor/pod,
/area/template_noop)
"x" = (
/obj/structure/window/shuttle/survival_pod,
/turf/open/floor/pod,
/area/template_noop)
"y" = (
/obj/machinery/door/airlock/survival_pod{
	random = 1
	},
/turf/open/floor/pod,
/area/template_noop)
"z" = (
/obj/machinery/door/airlock/survival_pod,
/turf/open/floor/pod,
/area/template_noop)
"A" = (
/obj/machinery/door/airlock/survival_pod{
	glass = 0;
	opacity = 1;
	random = 1
	},
/turf/open/floor/pod,
/area/template_noop)
"B" = (
/obj/structure/sign/securearea,
/turf/closed/wall/shuttle/survival/nodiagonal,
/area/template_noop)
"C" = (
/obj/effect/landmark/vr_spawn{
	name = "Escape"
	},
/obj/machinery/door/airlock/survival_pod/random,
/turf/open/floor/pod,
/area/template_noop)
"D" = (
/obj/machinery/door/airlock/survival_pod/vertical{
	glass = 0;
	opacity = 1;
	random = 1
	},
/turf/open/floor/pod,
/area/template_noop)
"E" = (
/obj/structure/table/reinforced,
/obj/item/weapon/pen,
/obj/item/weapon/paper_bin,
/turf/open/floor/pod,
/area/template_noop)
"F" = (
/obj/effect/landmark/vr_spawn{
	name = "Escape"
	},
/obj/machinery/door/airlock/survival_pod/vertical/random,
/turf/open/floor/pod,
/area/template_noop)
"G" = (
/obj/structure/flora/bush{
	density = 1
	},
/turf/open/floor/plating/asteroid/snow/temperatre{
	initial_gas_mix = "o2=22;n2=82;TEMP=293.15"
	},
/area/template_noop)

(1,1,1) = {"
a
a
c
c
c
c
c
c
a
a
a
a
a
a
a
a
a
a
a
a
a
a
a
a
a
a
a
"}
(2,1,1) = {"
a
a
c
e
e
e
e
c
a
a
a
a
a
a
a
a
a
a
a
a
b
b
b
b
b
b
b
"}
(3,1,1) = {"
a
a
c
f
m
e
e
c
a
a
a
a
a
a
a
a
a
a
a
a
b
b
d
d
b
b
d
"}
(4,1,1) = {"
a
a
c
g
l
e
e
c
a
a
a
a
a
a
a
a
a
a
a
a
b
b
b
b
b
d
b
"}
(5,1,1) = {"
a
a
c
e
i
e
e
c
a
a
a
a
c
c
c
c
c
c
c
c
d
b
b
b
d
b
b
"}
(6,1,1) = {"
a
a
c
e
e
e
e
c
c
c
c
c
c
f
j
l
n
j
i
c
d
o
b
b
b
d
b
"}
(7,1,1) = {"
a
a
c
e
e
e
e
x
e
q
e
e
x
e
u
e
e
u
e
c
d
b
b
b
b
b
b
"}
(8,1,1) = {"
a
a
c
h
e
e
e
y
e
e
e
e
y
e
e
e
e
e
e
c
d
b
b
b
d
b
d
"}
(9,1,1) = {"
a
a
c
i
n
q
e
x
e
e
e
e
x
e
e
e
e
q
q
c
d
b
G
G
G
d
b
"}
(10,1,1) = {"
a
a
c
c
c
c
c
c
c
c
D
c
c
c
x
x
x
c
c
c
B
F
B
c
c
a
a
"}
(11,1,1) = {"
a
a
a
a
c
r
r
r
c
e
e
e
c
q
e
e
e
q
c
e
e
e
q
q
c
a
a
"}
(12,1,1) = {"
a
a
a
a
c
e
e
e
x
e
e
e
c
e
e
c
e
e
c
e
e
e
q
q
c
a
a
"}
(13,1,1) = {"
a
a
a
a
c
e
v
e
x
e
e
e
c
e
q
c
q
e
c
e
e
c
c
c
c
a
a
"}
(14,1,1) = {"
a
a
a
a
c
e
e
e
z
e
e
e
A
e
q
c
q
e
A
e
e
e
e
q
c
a
a
"}
(15,1,1) = {"
a
a
a
a
c
e
e
e
x
e
e
e
c
e
c
c
c
e
c
q
e
e
e
q
c
a
a
"}
(16,1,1) = {"
a
a
a
a
c
e
v
e
x
e
e
e
c
e
e
e
e
e
c
c
c
c
e
q
c
a
a
"}
(17,1,1) = {"
a
a
a
a
c
e
e
e
x
e
e
e
c
q
e
e
q
q
c
q
e
e
e
q
c
a
a
"}
(18,1,1) = {"
a
a
a
a
c
s
w
w
c
e
e
e
c
c
c
D
c
c
c
c
c
D
c
c
c
a
a
"}
(19,1,1) = {"
a
a
c
c
c
c
c
c
c
e
e
e
c
q
e
e
e
q
c
q
e
e
e
q
c
a
a
"}
(20,1,1) = {"
a
a
c
j
e
e
e
e
c
e
e
e
c
q
e
e
e
e
c
e
c
e
c
e
c
a
a
"}
(21,1,1) = {"
a
a
c
j
e
i
n
e
c
e
e
e
c
c
c
c
c
e
c
e
e
e
e
e
c
a
a
"}
(22,1,1) = {"
a
a
c
j
e
t
k
e
A
e
e
e
A
e
e
e
c
e
A
e
c
q
c
e
c
a
a
"}
(23,1,1) = {"
a
a
c
j
e
l
f
e
c
e
e
e
c
e
e
e
c
e
c
e
e
e
e
e
c
a
a
"}
(24,1,1) = {"
a
a
c
j
e
e
e
e
c
e
e
e
c
q
e
e
e
e
c
e
c
e
c
e
c
a
a
"}
(25,1,1) = {"
a
a
c
c
c
c
c
c
c
e
e
e
c
q
q
e
e
q
c
q
e
e
e
q
c
a
a
"}
(26,1,1) = {"
b
b
d
d
d
d
d
d
c
e
e
e
c
c
c
D
c
c
c
c
c
D
c
c
c
a
a
"}
(27,1,1) = {"
b
b
d
b
d
b
b
d
c
q
e
e
c
q
e
e
e
q
c
q
e
e
q
q
c
a
a
"}
(28,1,1) = {"
b
b
b
d
b
b
b
d
B
e
e
e
c
q
e
e
e
q
c
q
e
e
c
c
c
a
a
"}
(29,1,1) = {"
b
b
d
b
o
b
b
b
C
e
e
e
c
c
c
e
c
c
c
e
e
e
e
q
c
a
a
"}
(30,1,1) = {"
b
b
b
b
b
b
b
d
B
e
e
e
A
e
e
e
e
q
A
e
q
c
e
q
c
a
a
"}
(31,1,1) = {"
b
b
b
d
b
d
b
d
c
q
e
e
c
q
e
c
e
e
c
e
c
c
e
c
c
a
a
"}
(32,1,1) = {"
b
b
d
b
d
b
b
d
c
e
e
e
c
q
e
c
e
e
c
e
e
e
e
q
c
a
a
"}
(33,1,1) = {"
b
b
d
d
b
d
d
d
c
e
e
e
c
e
e
c
q
q
c
q
e
e
e
q
c
a
a
"}
(34,1,1) = {"
a
a
c
c
c
c
c
c
c
c
D
c
c
c
x
x
x
c
c
c
B
F
B
c
c
a
a
"}
(35,1,1) = {"
a
a
c
k
i
f
e
x
e
e
e
e
x
q
q
e
e
e
i
c
d
b
G
G
G
b
b
"}
(36,1,1) = {"
a
a
c
l
p
e
e
y
e
e
e
e
y
e
e
e
e
g
n
c
d
b
b
b
b
b
d
"}
(37,1,1) = {"
a
a
c
e
e
e
e
x
e
q
e
e
x
e
h
e
e
e
j
c
d
b
b
b
b
d
b
"}
(38,1,1) = {"
a
a
c
e
e
e
e
c
c
c
c
c
c
i
j
n
j
l
E
c
d
b
o
b
b
b
b
"}
(39,1,1) = {"
a
a
c
e
f
n
i
c
a
a
a
a
c
c
c
c
c
c
c
c
d
b
b
b
b
d
b
"}
(40,1,1) = {"
a
a
c
e
e
u
e
c
a
a
a
a
a
a
a
a
a
a
a
a
b
b
d
b
b
b
b
"}
(41,1,1) = {"
a
a
c
c
c
c
c
c
a
a
a
a
a
a
a
a
a
a
a
a
b
b
b
b
d
b
d
"}
(42,1,1) = {"
a
a
a
a
a
a
a
a
a
a
a
a
a
a
a
a
a
a
a
a
b
b
b
b
b
b
b
"}
