"a" = (/turf/template_noop,/area/template_noop)
"b" = (/obj/structure/flora/rock/icy,/turf/template_noop,/area/template_noop)

(1,1,1) = {"
aaaaaaaaaaaaaaa
aaaaaaaaaaaaaaa
aaaaaaaaaaaaaaa
aaaaaaabaaaaaaa
aaaaaaaaaaaaaaa
aaabaaaaaaaabaa
aaaaaaaaaaaaaaa
aaaaaaaaaaaaaaa
abaaaaaaaaaaaab
aaaaaaaaaaaaaaa
aaaaaaaaaaaaaaa
aaaaaaaaaaaabaa
aaabaaaaaaaaaaa
aaaaaaabaaaaaaa
aaaaaaaaaaaaaaa
"}
