"a" = (/turf/template_noop,/area/template_noop)
"b" = (/obj/structure/flora/rock/icy,/turf/template_noop,/area/template_noop)

(1,1,1) = {"
aaaaaaaaaaaaaab
aaaaaaaaaaaaaaa
aaaaaaaaaaaaaaa
aaaaaaaaaaaaaaa
aaaaaaaaaaaabaa
abaaaaaaaaaaaaa
aaaaaaaaaaaaaaa
aaaaaaaaaaaaaaa
aaaaaaaaaaaaaaa
aaaaaaaaaaaaaaa
aaaaaaaaaaaaaaa
aaaaaaaaaaaaaaa
aaaaaaaaaaaaaaa
aaaaaaaabaaaaaa
aaaaaaaaaaaaaaa
"}
