"a" = (/turf/template_noop,/area/template_noop)
"b" = (/obj/structure/flora/tree/dead,/turf/template_noop,/area/template_noop)
"c" = (/obj/structure/flora/rock/icy,/turf/template_noop,/area/template_noop)

(1,1,1) = {"
aaaaaaaaaaaaaaa
aaaaaaaaaaaaaaa
aaaaaaaaaaaaaaa
aaaaaaaaaaaaaaa
aaaaaaaaaaaaaaa
aaaaaaaaaaaaaaa
aaaaaaaaaaaaaaa
aaaaaaaaaaaaaaa
aaaaaaaaaaaaaaa
aabaaaaaaaaaaaa
aaaaaaaaaaaaaaa
aaaaacaaaaaaaaa
aaaaaaaaacaaaaa
aaaaaaabaaaaaaa
aaaaaaaaaaaaaaa
"}
