"a" = (/turf/template_noop,/area/template_noop)
"b" = (/obj/structure/flora/rock/icy,/turf/template_noop,/area/template_noop)
"c" = (/obj/structure/flora/tree/dead,/turf/template_noop,/area/template_noop)

(1,1,1) = {"
aaaaaaaaaaaaaaa
aaaaaaaaaaaaaaa
aaaaaaaaaaaaaaa
aaaabaaaaaaaaca
aaaaaaaaaaaaaaa
aaaaaaaaaaaaaaa
aaaaaaaaaaaaaaa
aaaaaaaaaaaaaaa
aaaaaaaaaaaaaaa
aaaaaaaaaabaaaa
aaaaaaacaaaaaaa
aaaaaaaaaaaaaaa
aaaaaaaaaaaaaaa
aaaaaaaaaaaaaaa
aaaaaaaaaaaaaaa
"}
