"a" = (/turf/template_noop,/area/template_noop)
"b" = (/obj/structure/flora/tree/dead,/turf/template_noop,/area/template_noop)

(1,1,1) = {"
aaaaaaaaaaaaaaa
aaaaaaaaaaaaaaa
aaaaaaaaaaaaaaa
aaaaaaaaaaaaaaa
aaaaaababaaaaaa
aaaaaaabaaaaaaa
aaaaaababaaaaaa
aaaaaaaaaaaaaaa
aaaaaaaaaaaaaaa
aaaaaaaaaaaaaaa
aaaaaaaaaaaaaaa
abaaaaaaaaaaaaa
aaaaaaaaaaaaaaa
baaaaaaaaaaaaaa
aaaaaaaaaaaaaaa
"}
