"a" = (/turf/template_noop,/area/template_noop)
"b" = (/obj/structure/flora/rock/icy,/turf/template_noop,/area/template_noop)
"c" = (/obj/structure/flora/tree/dead,/turf/template_noop,/area/template_noop)

(1,1,1) = {"
aaaaaaaaaaaaaaa
aaaaabaaaaaaaaa
aaaaaaaaaaaaaaa
aaaaaaaaaaaaaaa
aaaaaaaaaaaaaaa
aaaaaaaaaaaaaaa
aaaaaaaaaaaaaaa
aaaaaaaaaaaaaaa
aaaaaaaaaaaaaaa
aaaaaaaaaabaaaa
aaaaaaaaaaaaaaa
aaaaaaaaaaaaaaa
aaaaaaaaaacaaaa
aaaaaaaaaaaaaaa
abaaaaaaaaaacaa
"}
