"a" = (/turf/template_noop,/area/template_noop)
"b" = (/obj/structure/flora/tree/dead,/turf/template_noop,/area/template_noop)

(1,1,1) = {"
aaaaaaaaaaaaaaa
aaaaaaaaaaaaaaa
aaaaaaaaaaaaaaa
aabaaaaaaaaaaaa
abaaaaaaaaaaaaa
aabaaaaaaaaaaaa
abaaaaaaaaaaaaa
aaaaaaaaaaaaaaa
aaaaaaaaaaaaaaa
aaaaaaaaaaaaaaa
aaaaaaaaaaaaaaa
aaaaaaaaabaaaaa
aaaaaaaaaaaaaaa
aaaaaaaaaaaaaaa
aaaaaaaaaaaaaaa
"}
