"a" = (/turf/template_noop,/area/template_noop)
"b" = (/obj/structure/flora/tree/dead,/turf/template_noop,/area/template_noop)

(1,1,1) = {"
aaaaaaaaaaaaaaa
abaaaaaaaaaaaaa
aaaaaaaaaaaaaba
aaaaaaaaaaaaaaa
aaaaaaaaaaaaaaa
aaaaaaaaaaaaaaa
aaaaaaaaaaaaaaa
aaaaaaaaaaaaaaa
aaaabaaaaaaaaaa
aaaaaaaaaaaaaaa
aaaaaaaaaaaaaaa
aaaaaaaaaaaaaaa
aaaaaaaaaaabaaa
abaaaaaaaaaaaaa
aaaaaaaaaaaaaaa
"}
